9 9 9 9 9 9 9 9 9 9 9 9 9 9 9 9 9 9 9 9 9 9 9 9 9 9 9 9 9 9 9 9 9 9 9 9 9 9 9 9 9 9 9 9 9 9 9 9 9 9
9 9 9 9 9 9 9 9 9 9 9 9 9 9 9 9 9 9 9 9 9 9 9 9 9 9 9 9 9 9 9 9 9 9 9 9 9 9 9 9 9 9 9 9 9 9 9 9 9 9
9 9 9 9 9 9 9 9 9 9 9 9 9 9 9 9 9 9 9 9 9 9 9 9 9 9 9 9 9 9 9 9 9 9 9 9 9 9 9 9 9 9 9 9 9 9 9 9 9 9
9 9 9 9 9 9 9 9 9 9 9 9 9 9 9 9 9 9 9 9 9 9 9 9 9 9 9 9 9 9 9 9 9 9 9 9 9 9 9 9 9 9 9 9 9 9 9 9 9 9
9 9 9 9 9 9 9 9 9 9 9 9 9 9 9 9 9 9 9 9 9 9 9 9 9 9 9 9 9 9 9 9 9 9 9 9 9 9 9 9 9 9 9 9 9 9 9 9 9 9
9 9 9 9 9 9 9 4 4 4 4 4 4 4 4 4 4 4 4 4 4 4 4 4 4 4 4 4 4 4 4 4 4 4 4 4 4 4 4 4 4 4 4 9 9 9 9 9 9 9 
9 9 9 9 9 9 9 4 10 10 10 10 10 10 10 10 10 10 10 10 10 10 10 10 10 10 10 10 10 10 10 10 10 10 10 10 10 10 10 10 10 10 4 9 9 9 9 9 9 9
9 9 9 9 9 9 9 4 10 10 10 10 10 10 10 10 10 10 10 10 10 10 10 10 10 10 10 10 10 10 10 10 10 10 10 10 10 10 10 10 10 10 4 9 9 9 9 9 9 9
9 9 9 9 9 9 9 4 10 10 10 10 10 10 10 10 10 10 10 10 10 10 10 10 10 10 10 10 10 10 10 10 10 10 10 10 10 10 10 10 10 10 4 9 9 9 9 9 9 9
9 9 9 9 9 9 9 4 10 10 10 10 10 10 10 10 10 10 10 10 10 10 10 10 10 10 10 10 10 10 10 10 10 10 10 10 10 10 10 10 10 10 4 9 9 9 9 9 9 9
9 9 9 9 9 9 9 4 10 10 10 10 10 10 10 10 10 10 10 10 10 12 12 12 12 12 12 12 12 10 10 10 10 10 10 10 10 10 10 10 10 10 4 9 9 9 9 9 9 9
9 9 9 9 9 9 9 4 10 10 10 10 10 10 10 10 10 10 10 12 12 12 12 12 12 45 12 12 11 11 11 10 10 10 10 10 10 10 10 10 10 10 4 9 9 9 9 9 9 9
9 9 9 9 9 9 9 4 10 10 10 10 10 10 10 10 10 10 12 12 12 12 12 12 12 11 11 11 11 11 11 12 10 10 10 10 10 10 10 10 10 10 4 9 9 9 9 9 9 9
9 9 9 9 9 9 9 4 10 10 10 10 10 10 10 10 10 12 12 12 12 12 11 11 11 11 11 11 11 11 11 11 12 10 10 10 10 10 10 10 10 10 4 9 9 9 9 9 9 9
9 9 9 9 9 9 9 4 10 10 10 10 10 10 10 10 12 12 12 12 12 11 11 11 11 11 11 11 11 11 11 11 11 12 10 10 10 10 10 10 10 10 4 9 9 9 9 9 9 9
9 9 9 9 9 9 9 4 10 10 10 10 10 10 10 11 12 11 11 11 11 11 11 11 11 11 11 11 11 11 11 11 11 11 12 10 10 10 10 10 10 10 4 9 9 9 9 9 9 9
9 9 9 9 9 9 9 4 10 10 10 10 10 10 10 11 12 11 11 11 11 11 11 11 11 11 11 11 11 11 11 11 11 11 12 10 10 10 10 10 10 10 4 9 9 9 9 9 9 9
9 9 9 9 9 9 9 4 10 10 10 10 10 10 11 11 11 11 11 12 12 12 12 11 11 11 11 11 11 12 12 12 12 12 12 12 10 10 10 10 10 10 4 9 9 9 9 9 9 9
9 9 9 9 9 9 9 4 10 10 10 10 10 10 11 11 11 11 12 12 12 12 11 11 11 11 11 11 11 12 12 12 12 12 12 12 10 10 10 10 10 10 4 9 9 9 9 9 9 9
9 9 9 9 9 9 9 4 10 10 10 10 10 10 11 11 11 11 12 12 12 12 12 11 11 11 11 11 12 12 12 12 12 12 12 12 10 10 10 10 10 10 4 9 9 9 9 9 9 9
9 9 9 9 9 9 9 4 10 10 10 10 10 10 11 11 11 12 12 12 12 12 12 11 11 11 11 12 12 12 12 12 12 12 12 12 10 10 10 10 10 10 4 9 9 9 9 9 9 9
9 9 9 9 9 9 9 4 10 10 10 10 10 10 11 11 11 12 12 12 12 12 12 11 11 11 11 11 12 12 12 12 12 12 12 12 10 10 10 10 10 10 4 9 9 9 9 9 9 9
9 9 9 9 9 9 9 4 10 10 10 10 10 10 11 11 11 11 12 12 12 12 12 11 11 11 11 11 11 12 12 12 12 12 12 12 10 10 10 10 10 10 4 9 9 9 9 9 9 9
9 9 9 9 9 9 9 4 10 10 10 10 10 10 11 11 11 11 11 12 12 11 11 11 11 11 11 11 11 12 12 12 12 12 12 12 10 10 10 10 10 10 4 9 9 9 9 9 9 9
9 9 9 9 9 9 9 4 10 10 10 10 10 10 10 11 11 11 11 12 11 11 11 11 11 11 11 11 11 12 12 12 12 12 11 10 10 10 10 10 10 10 4 9 9 9 9 9 9 9
9 9 9 9 9 9 9 4 10 10 10 10 10 10 10 11 11 11 11 11 11 11 11 11 11 11 11 11 11 12 12 12 12 12 11 10 10 10 10 10 10 10 4 9 9 9 9 9 9 9
9 9 9 9 9 9 9 4 10 10 10 10 10 10 10 10 11 11 11 11 11 11 11 11 11 11 11 11 11 12 12 12 12 11 10 10 10 10 10 10 10 10 4 9 9 9 9 9 9 9
9 9 9 9 9 9 9 4 10 10 10 10 10 10 10 10 10 11 11 11 11 11 11 11 11 11 11 11 12 12 11 11 11 10 10 10 10 10 10 10 10 10 4 9 9 9 9 9 9 9
9 9 9 9 9 9 9 4 10 10 10 10 10 10 10 10 10 10 11 11 11 11 11 11 11 11 11 11 11 12 12 11 10 10 10 10 10 10 10 10 10 10 4 9 9 9 9 9 9 9
9 9 9 9 9 9 9 4 10 10 10 10 10 10 10 10 10 10 10 13 13 13 13 13 13 13 13 13 11 11 11 10 10 10 10 10 10 10 10 10 10 10 4 9 9 9 9 9 9 9
9 9 9 9 9 9 9 4 10 10 10 10 10 10 10 10 10 10 10 10 10 13 13 13 13 13 13 13 13 10 10 10 10 10 10 10 10 10 10 10 10 10 4 9 9 9 9 9 9 9
9 9 9 9 9 9 9 4 10 10 10 10 10 10 10 10 10 10 10 10 10 10 10 10 10 10 10 10 10 10 10 10 10 10 10 10 10 10 10 10 10 10 4 9 9 9 9 9 9 9
9 9 9 9 9 9 9 4 10 10 10 10 10 10 10 10 10 10 10 10 10 10 10 10 10 10 10 10 10 10 10 10 10 10 10 10 10 10 10 10 10 38 4 9 9 9 9 9 9 9
9 9 9 9 9 9 9 4 10 10 10 10 10 10 10 10 10 10 10 10 10 10 10 10 10 10 10 10 10 10 10 10 10 10 10 10 10 10 10 10 35 41 4 9 9 9 9 9 9 9
9 9 9 9 9 9 9 4 4 4 4 4 4 4 4 4 4 4 4 4 4 4 4 4 4 4 4 4 4 4 4 4 4 4 4 4 4 4 4 4 4 4 4 9 9 9 9 9 9 9
9 9 9 9 9 9 9 9 9 9 9 9 9 9 9 9 9 9 9 9 9 9 9 9 9 9 9 9 9 9 9 9 9 9 9 9 9 9 9 9 9 9 9 9 9 9 9 9 9 9
9 9 9 9 9 9 9 9 9 9 9 9 9 9 9 9 9 9 9 9 9 9 9 9 9 9 9 9 9 9 9 9 9 9 9 9 9 9 9 9 9 9 9 9 9 9 9 9 9 9
9 9 9 9 9 9 9 9 9 9 9 9 9 9 9 9 9 9 9 9 9 9 9 9 9 9 9 9 9 9 9 9 9 9 9 9 9 9 9 9 9 9 9 9 9 9 9 9 9 9
9 9 9 9 9 9 9 9 9 9 9 9 9 9 9 9 9 9 9 9 9 9 9 9 9 9 9 9 9 9 9 9 9 9 9 9 9 9 9 9 9 9 9 9 9 9 9 9 9 9
9 9 9 9 9 9 9 9 9 9 9 9 9 9 9 9 9 9 9 9 9 9 9 9 9 9 9 9 9 9 9 9 9 9 9 9 9 9 9 9 9 9 9 9 9 9 9 9 9 9

