9 9 9 9 9 9 9 9 9 9 9 9 9 9 9 9 9 9 9 9 9 9 9 9 9 9 9 9 9 9 9 9 9 9 9 9 9 9 9 9 9 9 9 9 9 9 9 9 9 9
9 9 9 9 9 9 9 9 9 9 9 9 9 9 9 9 9 9 9 9 9 9 9 9 9 9 9 9 9 9 9 9 9 9 9 9 9 9 9 9 9 9 9 9 9 9 9 9 9 9
9 9 9 9 9 9 9 9 9 9 9 9 9 9 9 9 9 9 9 9 9 9 9 9 9 9 9 9 9 9 9 9 9 9 9 9 9 9 9 9 9 9 9 9 9 9 9 9 9 9
9 9 9 9 9 9 9 9 9 9 9 9 9 9 9 9 9 9 9 9 9 9 9 9 9 9 9 9 9 9 9 9 9 9 9 9 9 9 9 9 9 9 9 9 9 9 9 9 9 9
9 9 9 9 9 9 9 9 9 9 9 9 9 9 9 9 9 9 9 9 9 9 9 9 9 9 9 9 9 9 9 9 9 9 9 9 9 9 9 9 9 9 9 9 9 9 9 9 9 9
9 9 9 9 9 9 9 4 4 4 4 4 4 4 4 4 4 4 4 4 4 4 4 4 4 4 4 4 4 4 4 4 4 4 4 4 4 4 4 4 4 4 4 9 9 9 9 9 9 9 
9 9 9 9 9 9 9 4 10 10 10 10 10 10 10 10 10 10 10 10 10 10 14 14 14 14 14 14 14 10 10 10 10 10 10 10 10 10 10 10 10 10 4 9 9 9 9 9 9 9
9 9 9 9 9 9 9 4 10 10 10 10 10 10 10 10 10 10 10 10 10 14 17 17 14 45 17 16 17 14 10 10 10 10 10 10 10 10 10 10 10 10 4 9 9 9 9 9 9 9
9 9 9 9 9 9 9 4 10 10 10 10 10 10 10 10 10 10 10 10 14 17 17 16 16 15 16 16 16 16 14 10 10 10 10 10 10 10 10 10 10 10 4 9 9 9 9 9 9 9
9 9 9 9 9 9 9 4 10 10 10 10 10 10 10 10 10 10 10 14 17 17 16 17 16 15 16 17 17 16 16 14 10 10 10 10 10 10 10 10 10 10 4 9 9 9 9 9 9 9
9 9 9 9 9 9 9 4 10 10 10 10 10 10 10 10 10 10 14 17 17 16 16 15 15 15 16 17 17 16 16 17 14 10 10 10 10 10 10 10 10 10 4 9 9 9 9 9 9 9
9 9 9 9 9 9 9 4 10 10 10 10 10 10 10 10 10 14 17 17 17 16 15 15 15 15 16 17 17 17 17 17 17 14 10 10 10 10 10 10 10 10 4 9 9 9 9 9 9 9
9 9 9 9 9 9 9 4 10 10 10 10 10 10 10 10 14 17 17 16 16 16 15 16 15 15 17 17 17 17 17 17 17 17 14 10 10 10 10 10 10 10 4 9 9 9 9 9 9 9
9 9 9 9 9 9 9 4 10 10 10 10 10 10 10 14 14 17 16 16 16 16 16 16 16 15 17 17 17 17 17 17 16 17 17 14 10 10 10 10 10 10 4 9 9 9 9 9 9 9
9 9 9 9 9 9 9 4 10 10 10 10 10 10 14 14 15 15 15 15 16 15 16 16 16 15 17 17 16 17 16 16 16 16 17 14 14 10 10 10 10 10 4 9 9 9 9 9 9 9
9 9 9 9 9 9 9 4 10 10 10 10 10 10 15 15 15 17 15 15 15 15 15 16 16 15 17 17 16 16 16 16 16 16 17 15 14 10 10 10 10 10 4 9 9 9 9 9 9 9
9 9 9 9 9 9 9 4 10 10 10 10 10 15 14 15 15 15 16 15 15 16 15 15 16 15 16 17 16 16 16 16 15 16 16 15 15 14 10 10 10 10 4 9 9 9 9 9 9 9
9 9 9 9 9 9 9 4 10 10 10 10 14 15 15 15 15 15 16 16 16 15 15 15 15 15 16 16 16 16 16 15 15 16 16 15 16 16 14 10 10 10 4 9 9 9 9 9 9 9
9 9 9 9 9 9 9 4 10 10 10 10 14 15 15 16 16 15 16 15 16 16 15 15 15 15 16 16 16 15 15 15 15 15 15 15 16 16 14 10 10 10 4 9 9 9 9 9 9 9
9 9 9 9 9 9 9 4 10 10 10 10 14 15 15 16 16 15 15 15 16 16 15 15 15 15 15 16 16 15 15 15 15 15 16 16 16 16 14 10 10 10 4 9 9 9 9 9 9 9
9 9 9 9 9 9 9 4 10 10 10 10 14 16 16 16 15 15 15 15 16 15 16 16 15 15 15 16 17 17 15 15 17 15 15 16 16 16 14 10 10 10 4 9 9 9 9 9 9 9
9 9 9 9 9 9 9 4 10 10 10 10 14 16 16 15 15 16 15 16 16 15 15 15 15 15 15 16 15 15 15 17 15 15 15 15 16 15 14 10 10 10 4 9 9 9 9 9 9 9
9 9 9 9 9 9 9 4 10 10 10 10 14 16 15 15 15 15 16 16 15 15 15 15 16 15 15 16 16 16 15 16 15 16 15 15 16 15 14 10 10 10 4 9 9 9 9 9 9 9
9 9 9 9 9 9 9 4 10 10 10 10 14 16 15 15 14 15 16 16 16 15 15 15 16 16 15 15 16 16 16 16 16 16 15 15 15 15 14 10 10 10 4 9 9 9 9 9 9 9
9 9 9 9 9 9 9 4 10 10 10 10 14 15 15 15 14 15 15 15 15 15 15 16 15 16 15 15 16 16 16 15 16 15 15 16 16 14 10 10 10 10 4 9 9 9 9 9 9 9
9 9 9 9 9 9 9 4 10 10 10 10 10 15 15 15 14 14 15 15 16 15 14 15 15 16 14 15 16 16 15 15 15 15 15 16 14 10 10 10 10 10 4 9 9 9 9 9 9 9
9 9 9 9 9 9 9 4 10 10 10 10 10 10 15 15 14 14 14 15 15 14 16 15 15 16 14 15 16 16 15 15 15 16 15 14 10 10 10 10 10 10 4 9 9 9 9 9 9 9
9 9 9 9 9 9 9 4 10 10 10 10 10 10 10 14 14 14 15 15 15 14 15 15 15 15 14 14 15 15 15 16 16 16 16 10 10 10 10 10 10 10 4 9 9 9 9 9 9 9
9 9 9 9 9 9 9 4 10 10 10 10 10 10 10 10 14 15 15 15 15 15 15 15 15 15 14 14 14 15 15 16 16 16 10 10 10 10 10 10 10 10 4 9 9 9 9 9 9 9
9 9 9 9 9 9 9 4 10 10 10 10 10 10 10 10 10 14 14 15 15 15 15 15 15 15 14 14 14 15 15 15 15 10 10 10 10 10 10 10 10 10 4 9 9 9 9 9 9 9
9 9 9 9 9 9 9 4 10 10 10 10 10 10 10 10 10 10 14 15 14 15 15 15 15 15 14 15 15 15 15 15 10 10 10 10 10 10 10 10 10 10 4 9 9 9 9 9 9 9
9 9 9 9 9 9 9 4 10 10 10 10 10 10 10 10 10 10 10 14 14 14 14 16 15 15 15 15 15 14 14 10 10 10 10 10 10 10 10 10 10 10 4 9 9 9 9 9 9 9
9 9 9 9 9 9 9 4 10 10 10 10 10 10 10 10 10 10 10 10 14 14 14 16 16 14 15 15 15 14 10 10 10 10 10 10 10 10 10 10 10 38 4 9 9 9 9 9 9 9
9 9 9 9 9 9 9 4 10 10 10 10 10 10 10 10 10 10 10 10 10 14 14 14 14 14 14 14 14 10 10 10 10 10 10 10 10 10 10 10 35 41 4 9 9 9 9 9 9 9
9 9 9 9 9 9 9 4 4 4 4 4 4 4 4 4 4 4 4 4 4 4 4 4 4 4 4 4 4 4 4 4 4 4 4 4 4 4 4 4 4 4 4 9 9 9 9 9 9 9
9 9 9 9 9 9 9 9 9 9 9 9 9 9 9 9 9 9 9 9 9 9 9 9 9 9 9 9 9 9 9 9 9 9 9 9 9 9 9 9 9 9 9 9 9 9 9 9 9 9
9 9 9 9 9 9 9 9 9 9 9 9 9 9 9 9 9 9 9 9 9 9 9 9 9 9 9 9 9 9 9 9 9 9 9 9 9 9 9 9 9 9 9 9 9 9 9 9 9 9
9 9 9 9 9 9 9 9 9 9 9 9 9 9 9 9 9 9 9 9 9 9 9 9 9 9 9 9 9 9 9 9 9 9 9 9 9 9 9 9 9 9 9 9 9 9 9 9 9 9
9 9 9 9 9 9 9 9 9 9 9 9 9 9 9 9 9 9 9 9 9 9 9 9 9 9 9 9 9 9 9 9 9 9 9 9 9 9 9 9 9 9 9 9 9 9 9 9 9 9
9 9 9 9 9 9 9 9 9 9 9 9 9 9 9 9 9 9 9 9 9 9 9 9 9 9 9 9 9 9 9 9 9 9 9 9 9 9 9 9 9 9 9 9 9 9 9 9 9 9