9 9 9 9 9 9 9 9 9 9 9 9 9 9 9 9 9 9 9 9 9 9 9 9 9 9 9 9 9 9 9 9 9 9 9 9 9 9 9 9 9 9 9 9 9 9 9 9 9 9
9 9 9 9 9 9 9 9 9 9 9 9 9 9 9 9 9 9 9 9 9 9 9 9 9 9 9 9 9 9 9 9 9 9 9 9 9 9 9 9 9 9 9 9 9 9 9 9 9 9
9 9 9 9 9 9 9 9 9 9 9 9 9 9 9 9 9 9 9 9 9 9 9 9 9 9 9 9 9 9 9 9 9 9 9 9 9 9 9 9 9 9 9 9 9 9 9 9 9 9
9 9 9 9 9 9 9 9 9 9 9 9 9 9 9 9 9 9 9 9 9 9 9 9 9 9 9 9 9 9 9 9 9 9 9 9 9 9 9 9 9 9 9 9 9 9 9 9 9 9
9 9 9 9 9 9 9 9 9 9 9 9 9 9 9 9 9 9 9 9 9 9 9 9 9 9 9 9 9 9 9 9 9 9 9 9 9 9 9 9 9 9 9 9 9 9 9 9 9 9
9 9 9 9 9 9 9 4 4 4 4 4 4 4 4 4 4 4 4 4 4 4 4 4 4 4 4 4 4 4 4 4 4 4 4 4 4 4 4 4 4 4 4 9 9 9 9 9 9 9 
9 9 9 9 9 9 9 4 10 10 10 10 10 10 10 10 10 10 10 10 10 10 10 10 10 10 10 10 10 10 10 10 10 10 10 10 10 10 10 10 10 10 4 9 9 9 9 9 9 9
9 9 9 9 9 9 9 4 10 10 10 10 10 10 10 10 10 10 10 10 10 10 10 10 10 10 10 10 10 10 10 10 10 10 10 10 10 10 10 10 10 10 4 9 9 9 9 9 9 9
9 9 9 9 9 9 9 4 10 10 10 10 10 10 10 10 10 10 10 10 10 10 10 10 10 10 10 10 10 10 10 10 10 10 10 10 10 10 10 10 10 10 4 9 9 9 9 9 9 9
9 9 9 9 9 9 9 4 10 10 10 10 10 10 10 10 10 10 10 10 10 10 10 10 10 10 10 10 10 10 10 10 10 10 10 10 10 10 10 10 10 10 4 9 9 9 9 9 9 9
9 9 9 9 9 9 9 4 10 10 10 10 10 10 10 10 10 10 10 10 10 10 10 10 10 10 10 10 10 10 10 10 10 10 10 10 10 10 10 10 10 10 4 9 9 9 9 9 9 9
9 9 9 9 9 9 9 4 10 10 10 10 10 10 10 10 10 10 10 10 10 10 10 10 10 10 10 10 10 10 10 10 10 10 10 10 10 10 10 10 10 10 4 9 9 9 9 9 9 9
9 9 9 9 9 9 9 4 10 10 10 10 10 10 10 10 10 10 10 10 10 10 10 10 10 10 10 10 10 10 10 10 10 10 10 10 10 10 10 10 10 10 4 9 9 9 9 9 9 9
9 9 9 9 9 9 9 4 10 10 10 10 10 10 10 10 10 10 10 10 10 10 10 10 10 10 10 10 10 10 10 10 10 10 10 10 10 10 10 10 10 10 4 9 9 9 9 9 9 9
9 9 9 9 9 9 9 4 10 10 10 10 10 10 10 10 10 10 10 10 10 10 10 10 10 10 10 10 10 10 10 10 10 10 10 10 10 10 10 10 10 10 4 9 9 9 9 9 9 9
9 9 9 9 9 9 9 4 10 10 10 10 10 10 10 10 10 2 2 10 10 10 10 10 10 10 10 10 10 10 10 10 10 10 10 10 10 10 10 10 10 10 4 9 9 9 9 9 9 9
9 9 9 9 9 9 9 4 10 10 10 10 10 10 10 10 2 2 2 2 10 10 10 2 2 2 2 2 2 10 10 10 10 10 10 10 10 10 10 10 10 10 4 4 4 4 9 9 9 9
9 9 9 9 9 9 9 4 10 10 10 10 10 10 10 10 2 2 2 2 10 10 2 5 5 5 5 5 5 2 10 10 10 10 10 10 10 10 10 10 10 10 10 10 45 4 9 9 9 9 9 9 9
9 9 9 9 9 9 9 4 10 10 10 10 10 10 10 10 10 2 2 10 10 2 5 5 5 5 5 5 5 5 2 10 10 10 10 10 10 10 10 10 10 10 4 4 4 4 9 9 9 9
9 9 9 9 9 9 9 4 10 10 10 10 10 10 10 10 10 10 10 10 10 2 5 5 5 5 5 5 5 5 2 10 10 10 10 10 10 10 10 10 10 10 4 9 9 9 9 9 9 9
9 9 9 9 9 9 9 4 10 10 10 10 10 10 10 10 10 10 10 10 10 5 5 5 5 5 5 5 5 5 5 10 10 10 10 10 10 10 10 10 10 10 4 9 9 9 9 9 9 9
9 9 9 9 9 9 9 4 10 10 10 10 10 10 10 10 10 10 10 10 10 5 5 5 5 5 5 5 5 5 5 10 10 10 10 10 10 10 10 10 10 10 4 9 9 9 9 9 9 9
9 9 9 9 9 9 9 4 10 10 10 10 10 10 10 10 10 10 10 10 10 5 5 5 5 5 5 5 5 5 5 10 10 10 10 10 10 10 10 10 10 10 4 9 9 9 9 9 9 9
9 9 9 9 9 9 9 4 10 10 10 10 10 10 10 10 10 10 10 10 10 2 5 5 5 5 5 5 5 5 2 10 10 10 10 10 10 10 10 10 10 10 4 9 9 9 9 9 9 9
9 9 9 9 9 9 9 4 10 10 10 10 10 10 10 10 10 10 10 10 10 2 5 5 5 5 5 5 5 5 2 10 10 10 10 10 10 10 10 10 10 10 4 9 9 9 9 9 9 9
9 9 9 9 9 9 9 4 10 10 10 10 10 10 10 10 10 10 10 10 10 10 2 5 5 5 5 5 5 2 10 10 10 10 10 10 10 10 10 10 10 10 4 9 9 9 9 9 9 9
9 9 9 9 9 9 9 4 10 10 10 10 10 10 10 10 10 10 10 10 10 10 10 2 2 2 2 2 2 10 10 10 10 10 10 10 10 10 10 10 10 10 4 9 9 9 9 9 9 9
9 9 9 9 9 9 9 4 10 10 10 10 10 10 10 10 10 10 10 10 10 10 10 10 10 10 10 10 10 10 10 10 10 10 10 10 10 10 10 10 10 10 4 9 9 9 9 9 9 9
9 9 9 9 9 9 9 4 10 10 10 10 10 10 10 10 10 10 10 10 10 10 10 10 10 10 10 10 10 10 10 10 10 10 10 10 10 10 10 10 10 10 4 9 9 9 9 9 9 9
9 9 9 9 9 9 9 4 10 10 10 10 10 10 10 10 10 10 10 10 10 10 10 10 10 10 10 10 10 10 10 10 10 10 10 10 10 10 10 10 10 10 4 9 9 9 9 9 9 9
9 9 9 9 9 9 9 4 10 10 10 10 10 10 10 10 10 10 10 10 10 10 10 10 10 10 10 10 10 10 10 10 10 10 10 10 10 10 10 10 10 10 4 9 9 9 9 9 9 9
9 9 9 9 9 9 9 4 10 10 10 10 10 10 10 10 10 10 10 10 10 10 10 10 10 10 10 10 10 10 10 10 10 10 10 10 10 10 10 10 10 10 4 9 9 9 9 9 9 9
9 9 9 9 9 9 9 4 10 10 10 10 10 10 10 10 10 10 10 10 10 10 10 10 10 10 10 10 10 10 10 10 10 10 10 10 10 10 10 10 10 38 4 9 9 9 9 9 9 9
9 9 9 9 9 9 9 4 10 10 10 10 10 10 10 10 10 10 10 10 10 10 10 10 10 10 10 10 10 10 10 10 10 10 10 10 10 10 10 10 35 41 4 9 9 9 9 9 9 9
9 9 9 9 9 9 9 4 4 4 4 4 4 4 4 4 4 4 4 4 4 4 4 4 4 4 4 4 4 4 4 4 4 4 4 4 4 4 4 4 4 4 4 9 9 9 9 9 9 9
9 9 9 9 9 9 9 9 9 9 9 9 9 9 9 9 9 9 9 9 9 9 9 9 9 9 9 9 9 9 9 9 9 9 9 9 9 9 9 9 9 9 9 9 9 9 9 9 9 9
9 9 9 9 9 9 9 9 9 9 9 9 9 9 9 9 9 9 9 9 9 9 9 9 9 9 9 9 9 9 9 9 9 9 9 9 9 9 9 9 9 9 9 9 9 9 9 9 9 9
9 9 9 9 9 9 9 9 9 9 9 9 9 9 9 9 9 9 9 9 9 9 9 9 9 9 9 9 9 9 9 9 9 9 9 9 9 9 9 9 9 9 9 9 9 9 9 9 9 9
9 9 9 9 9 9 9 9 9 9 9 9 9 9 9 9 9 9 9 9 9 9 9 9 9 9 9 9 9 9 9 9 9 9 9 9 9 9 9 9 9 9 9 9 9 9 9 9 9 9
9 9 9 9 9 9 9 9 9 9 9 9 9 9 9 9 9 9 9 9 9 9 9 9 9 9 9 9 9 9 9 9 9 9 9 9 9 9 9 9 9 9 9 9 9 9 9 9 9 9