9 9 9 9 9 9 9 9 9 9 9 9 9 9 9 9 9 9 9 9 9 9 9 9 9 9 9 9 9 9 9 9 9 9 9 9 9 9 9 9 9 9 9 9 9 9 9 9 9 9
9 9 9 9 9 9 9 9 9 9 9 9 9 9 9 9 9 9 9 9 9 9 9 9 9 9 9 9 9 9 9 9 9 9 9 9 9 9 9 9 9 9 9 9 9 9 9 9 9 9
9 9 9 9 9 9 9 9 9 9 9 9 9 9 9 9 9 9 9 9 9 9 9 9 9 9 9 9 9 9 9 9 9 9 9 9 9 9 9 9 9 9 9 9 9 9 9 9 9 9
9 9 9 9 9 9 9 9 9 9 9 9 9 9 9 9 9 9 9 9 9 9 9 9 9 9 9 9 9 9 9 9 9 9 9 9 9 9 9 9 9 9 9 9 9 9 9 9 9 9
9 9 9 9 9 9 9 9 9 9 9 9 9 9 9 9 9 9 9 9 9 9 9 9 9 9 9 9 9 9 9 9 9 9 9 9 9 9 9 9 9 9 9 9 9 9 9 9 9 9
9 9 9 9 9 9 9 4 4 4 4 4 4 4 4 4 4 4 4 4 4 4 4 4 4 4 4 4 4 4 4 4 4 4 4 4 4 4 4 4 4 4 4 9 9 9 9 9 9 9 
9 9 9 9 9 9 9 4 2 2 2 2 2 2 2 2 2 2 2 2 2 2 2 2 2 2 2 2 2 2 2 2 2 2 2 2 2 2 2 2 2 4 4 9 9 9 9 9 9 9
9 9 9 9 9 9 9 4 2 22 22 22 22 22 22 22 22 22 22 22 22 22 22 22 22 22 22 22 22 22 22 22 22 22 22 22 22 22 22 22 22 2 4 9 9 9 9 9 9 9
9 9 9 9 9 9 9 4 2 22 22 22 22 22 22 22 22 22 22 22 22 22 22 22 22 22 22 22 22 22 22 22 22 22 22 22 22 22 22 22 22 2 4 9 9 9 9 9 9 9
9 9 9 9 9 9 9 4 2 22 22 22 22 22 22 22 22 22 22 22 22 22 00 00 00 00 00 00 22 22 22 22 22 22 22 22 22 22 22 22 22 2 4 9 9 9 9 9 9 9
9 9 9 9 9 9 9 4 2 22 22 22 22 22 22 22 22 22 22 22 00 00 00 00 00 00 00 00 00 00 22 22 22 22 22 22 22 22 22 22 22 2 4 9 9 9 9 9 9 9
9 9 9 9 9 9 9 4 2 22 22 22 22 22 22 22 22 22 00 00 00 00 00 00 00 00 00 00 00 00 00 00 22 22 22 22 22 22 22 22 22 2 4 9 9 9 9 9 9 9
9 9 9 9 9 9 9 4 2 22 22 22 22 22 22 22 22 00 00 00 00 00 00 00 00 00 00 00 00 00 00 00 00 22 22 22 22 22 22 22 22 2 4 9 9 9 9 9 9 9
9 9 9 9 9 9 9 4 2 22 22 22 22 22 22 22 00 00 00 00 00 00 00 00 00 00 00 00 00 00 00 00 00 00 22 22 22 22 22 22 22 2 4 9 9 9 9 9 9 9
9 9 9 9 9 9 9 4 2 22 22 22 22 22 22 22 00 00 00 00 00 00 00 00 00 00 00 00 00 00 00 00 00 00 00 22 22 22 22 22 22 2 4 9 9 9 9 9 9 9
9 9 9 9 9 9 9 4 2 22 22 22 22 22 22 00 00 00 00 00 00 00 00 00 00 00 00 00 00 00 00 00 00 00 00 22 22 22 22 22 22 2 4 9 9 9 9 9 9 9
9 9 9 9 9 9 9 4 2 22 22 22 22 22 00 00 00 00 00 00 00 00 00 00 00 00 00 00 00 00 00 00 00 00 00 00 22 22 22 22 22 2 4 9 9 9 9 9 9 9
9 9 9 9 9 9 9 4 2 22 22 22 22 22 00 00 00 00 00 00 00 00 00 00 00 00 00 00 00 00 00 00 00 00 00 00 22 22 22 22 22 2 4 9 9 9 9 9 9 9
9 9 9 9 9 9 9 4 2 22 22 22 22 22 00 00 00 00 00 00 00 00 00 00 00 00 00 00 00 00 00 00 00 00 00 00 22 22 22 22 22 2 4 9 9 9 9 9 9 9
9 9 9 9 9 9 9 4 2 22 22 22 22 00 00 00 00 00 00 00 00 00 00 00 00 00 00 00 00 00 00 00 00 00 00 00 00 22 22 22 22 2 4 9 9 9 9 9 9 9
9 9 9 9 9 9 9 4 2 22 22 22 22 00 00 00 00 00 00 00 00 00 00 00 00 00 00 00 00 00 00 00 00 00 00 00 00 22 22 22 22 2 4 9 9 9 9 9 9 9
9 9 9 9 9 9 9 4 2 22 22 22 22 00 00 00 00 00 00 00 00 00 00 00 00 00 00 00 00 00 00 00 00 00 00 00 00 22 22 22 22 2 4 9 9 9 9 9 9 9
9 9 9 9 9 9 9 4 2 22 22 22 22 22 00 00 00 00 00 00 00 00 00 00 00 00 00 00 00 00 00 00 00 00 00 00 22 22 22 22 22 2 4 9 9 9 9 9 9 9
9 9 9 9 9 9 9 4 2 22 22 22 22 22 00 00 00 00 00 00 00 00 00 00 00 00 00 00 00 00 00 00 00 00 00 00 22 22 22 22 22 2 4 9 9 9 9 9 9 9
9 9 9 9 9 9 9 4 2 22 22 22 22 22 22 00 00 00 00 00 00 00 00 00 00 00 00 00 00 00 00 00 00 00 00 22 22 22 22 22 22 2 4 9 9 9 9 9 9 9
9 9 9 9 9 9 9 4 2 22 22 22 22 22 22 00 00 00 00 00 00 00 00 00 00 00 00 00 00 00 00 00 00 00 00 22 22 22 22 22 22 2 4 9 9 9 9 9 9 9
9 9 9 9 9 9 9 4 2 22 22 22 22 22 22 22 00 00 00 00 00 00 00 00 00 00 00 00 00 00 00 00 00 00 22 22 22 22 22 22 22 2 4 9 9 9 9 9 9 9
9 9 9 9 9 9 9 4 2 22 22 22 22 22 22 22 22 00 00 00 00 00 00 00 00 00 00 00 00 00 00 00 00 22 22 22 22 22 22 22 22 2 4 9 9 9 9 9 9 9
9 9 9 9 9 9 9 4 2 22 22 22 22 22 22 22 22 22 00 00 00 00 00 00 00 00 00 00 00 00 00 00 22 22 22 22 22 22 22 22 22 2 4 9 9 9 9 9 9 9
9 9 9 9 9 9 9 4 2 22 22 22 22 22 22 22 22 22 22 22 00 00 00 00 00 00 00 00 00 00 22 22 22 22 22 22 22 22 22 22 22 2 4 9 9 9 9 9 9 9
9 9 9 9 9 9 9 4 2 22 22 22 22 22 22 22 22 22 22 22 22 22 00 00 00 00 00 00 22 22 22 22 22 22 22 22 22 22 22 22 22 2 4 9 9 9 9 9 9 9
9 9 9 9 9 9 9 4 2 22 22 22 22 22 22 22 22 22 22 22 22 22 22 22 22 22 22 22 22 22 22 22 22 22 22 22 22 22 22 22 22 2 4 9 9 9 9 9 9 9
9 9 9 9 9 9 9 4 2 22 22 22 22 22 22 22 22 22 22 22 22 22 22 22 22 22 22 22 22 22 22 22 22 22 22 22 22 22 22 22 22 38 4 9 9 9 9 9 9 9
9 9 9 9 9 9 9 4 4 2 2 2 2 2 2 2 2 2 2 2 2 2 2 2 2 2 2 2 2 2 2 2 2 2 2 2 2 2 2 2 35 41 4 9 9 9 9 9 9 9
9 9 9 9 9 9 9 4 4 4 4 4 4 4 4 4 4 4 4 4 4 4 4 4 4 4 4 4 4 4 4 4 4 4 4 4 4 4 4 4 4 4 4 9 9 9 9 9 9 9
9 9 9 9 9 9 9 9 9 9 9 9 9 9 9 9 9 9 9 9 9 9 9 9 9 9 9 9 9 9 9 9 9 9 9 9 9 9 9 9 9 9 9 9 9 9 9 9 9 9
9 9 9 9 9 9 9 9 9 9 9 9 9 9 9 9 9 9 9 9 9 9 9 9 9 9 9 9 9 9 9 9 9 9 9 9 9 9 9 9 9 9 9 9 9 9 9 9 9 9
9 9 9 9 9 9 9 9 9 9 9 9 9 9 9 9 9 9 9 9 9 9 9 9 9 9 9 9 9 9 9 9 9 9 9 9 9 9 9 9 9 9 9 9 9 9 9 9 9 9
9 9 9 9 9 9 9 9 9 9 9 9 9 9 9 9 9 9 9 9 9 9 9 9 9 9 9 9 9 9 9 9 9 9 9 9 9 9 9 9 9 9 9 9 9 9 9 9 9 9
9 9 9 9 9 9 9 9 9 9 9 9 9 9 9 9 9 9 9 9 9 9 9 9 9 9 9 9 9 9 9 9 9 9 9 9 9 9 9 9 9 9 9 9 9 9 9 9 9 9